BBBBBBBBBBBBBBBBBBBBB
B                   B
B B B B B B B B B B B
B     DDD           B
B B B B B B B B B B B
B             D     B
B BDB B B B B B B B B
B  D    D           B
B BDB B B B B B B B B
B  DD       D       B
B BDB B B B B B B B B
B     D   D         B
B B B B B B B B B B B
B                   B
B B B B B B B B B B B
B                   B
BBBBBBBBBBBBBBBBBBBBB